
### West Eur
WLL = "countries/WestEur.txt" #Wallonia
FLN = "countries/WestEur.txt" #Flanders
BOS = "countries/WestEur.txt" #Bosnia
LOR = "countries/WestEur.txt" #Lorraine
GRN = "countries/WestEur.txt" #Greenland
GER = "countries/WestEur.txt" #Germany
RUS = "countries/WestEur.txt" #Russia
SWE = "countries/WestEur.txt" #Sweden
FRA = "countries/WestEur.txt" #France
LUX = "countries/WestEur.txt" #Luxembourg
BEL = "countries/WestEur.txt" #Belgium
HOL = "countries/WestEur.txt" #Holland
DEI = "countries/WestEur.txt" #Dutch East Indies
CZE = "countries/WestEur.txt" #Czechoslavokia
POL = "countries/WestEur.txt" #Poland
AUS = "countries/WestEur.txt" #Austria
ITA = "countries/WestEur.txt" #Italy
ROM = "countries/WestEur.txt" #Romania
TRS = "countries/WestEur.txt" #Transylvania
YUG = "countries/WestEur.txt" #Yugoslavia
SER = "countries/WestEur.txt" #Serbia
FIU = "countries/WestEur.txt" #Fiume
SWI = "countries/WestEur.txt" #Switzerland
GRE = "countries/WestEur.txt" #Greece
ALB = "countries/WestEur.txt" #Albania
NOR = "countries/WestEur.txt" #Norway
DEN = "countries/WestEur.txt" #Denmark
BUL = "countries/WestEur.txt" #Bulgaria
POR = "countries/WestEur.txt" #Portugal
FIN = "countries/WestEur.txt" #Finland
HUN = "countries/WestEur.txt" #Hungary
NRO = "countries/WestEur.txt" #Occupied Norway
CRO = "countries/WestEur.txt" #Croatia
ICE = "countries/WestEur.txt" #Iceland
SPR = "countries/WestEur.txt" #Spanish Republic
SPA = "countries/WestEur.txt" #Spanish Accelerationists
CNT = "countries/WestEur.txt" #Beautiful Spanish Anarchists
FAL = "countries/WestEur.txt" #Dirty Spanish Reactionaries
RHI = "countries/WestEur.txt" #Rhineland
PRS = "countries/WestEur.txt" #German Empire (Prussia)
SOR = "countries/WestEur.txt" #Sorbia
SLV = "countries/WestEur.txt" #Slovenia
MAC = "countries/WestEur.txt" #Macedonia
ASC = "countries/WestEur.txt" #Revolting Austrians

NBE = "countries/WestEur.txt" #New Belgium
PCN = "countries/WestEur.txt" #Prussian Congo
MRT = "countries/WestEur.txt" #Mauritania
PRR = "countries/WestEur.txt" #Prussian Civil War
BAV = "countries/WestEur.txt" #Bavaria
FLO = "countries/WestEur.txt" #New Polish Republic
POA = "countries/WestEur.txt" #Riograndense Republic
NEU = "countries/WestEur.txt" #New Silesia
PRP = "countries/WestEur.txt" #Hetmanate of Brazil
MOG = "countries/WestEur.txt" #Nikkei Burasiru
CRA = "countries/WestEur.txt" #Rondon's Army
FAC = "countries/WestEur.txt" #Filinto's Army
GCC = "countries/WestEur.txt" #Goi's Clique
BCQ = "countries/WestEur.txt" #Bley's Clique
ACQ = "countries/WestEur.txt" #Aleixo's Army
ASS = "countries/WestEur.txt" #Amazonian Scientific Territory
MCM = "countries/WestEur.txt" #Manau's Commune
FCQ = "countries/WestEur.txt" #Campo's Clique
DOA = "countries/WestEur.txt" #Duchy of Aquitaine
ISR = "countries/WestEur.txt" #Israel
GRI = "countries/WestEur.txt" #Italian Coup
BRT = "countries/WestEur.txt" #Brittany

### Com West
CAN = "countries/Commonw.txt" #Canada
QUE = "countries/Commonw.txt" #Quebec
NFL = "countries/Commonw.txt" #Newfoundland
USA = "countries/Commonw.txt" #United States of America
LOU = "countries/Commonw.txt" #New France (Louisiana)
VOL = "countries/Commonw.txt" #Volkstaat
WAS = "countries/Commonw.txt" #Westralia
AST = "countries/Commonw.txt" #East Westralia (Australia)
ENG = "countries/Commonw.txt" #United Kingdom
NZL = "countries/Commonw.txt" #New Zealand
SCO = "countries/Commonw.txt" #Scotland
WAL = "countries/Commonw.txt" #Wales
IRE = "countries/Commonw.txt" #Ireland
WAF = "countries/Commonw.txt" #West African Federation
SWF = "countries/Commonw.txt" #South West Africa

# US Breakaways #
SEG = "countries/Commonw.txt" #Western Emergency Command
JEF = "countries/Commonw.txt" #Jefferson
CAL = "countries/Commonw.txt" #California
DST = "countries/Commonw.txt" #Deseret
WYO = "countries/Commonw.txt" #Rocky Mountains
DAK = "countries/Commonw.txt" #Dakota
PUR = "countries/Commonw.txt" #Plains Union
OKL = "countries/Commonw.txt" #Oklahoma
MCO = "countries/Commonw.txt" #New Mex-Colorado
TEX = "countries/Commonw.txt" #Texas
MOS = "countries/Commonw.txt" #Missouri
DIX = "countries/Commonw.txt" #Emergency US
KNW = "countries/Commonw.txt" #Kanawha
VMT = "countries/Commonw.txt" #Vermont
NEE = "countries/Commonw.txt" #New England
PHX = "countries/Commonw.txt" #Phoenix
HAW = "countries/Commonw.txt" #Hawaii
NAV = "countries/Commonw.txt" #Navajo
NYC = "countries/Commonw.txt" #New York City

### East Eur
LIT = "countries/EastEur.txt" #Lithuania
EST = "countries/EastEur.txt" #Estonia
LAT = "countries/EastEur.txt" #Latvia
MOL = "countries/EastEur.txt" #Moldova
TUR = "countries/EastEur.txt" #Turkey
SRU = "countries/EastEur.txt" #New Russia (idk)
WRU = "countries/EastEur.txt" #West Russia
DKB = "countries/EastEur.txt" #Don-Kuban
FIR = "countries/EastEur.txt" #Commie Fins
UKR = "countries/EastEur.txt" #Ukraine
NUK = "countries/EastEur.txt" #New Ukraine
GEO = "countries/EastEur.txt" #Georgia
KAZ = "countries/EastEur.txt" #Kazakhstan
AZR = "countries/EastEur.txt" #Azerbaijan
ARM = "countries/EastEur.txt" #Armenia
BLR = "countries/EastEur.txt" #Belarus
SLO = "countries/EastEur.txt" #Slovakia
MNT = "countries/EastEur.txt" #Roman Empire (Montenegro)
KAV = "countries/EastEur.txt" #Kavkaz Society
ZHR = "countries/EastEur.txt" #Zheltorossiya
KCK = "countries/EastEur.txt" #Kamchatka
ORE = "countries/EastEur.txt" #Orenburg
ALT = "countries/EastEur.txt" #Altay
SIB = "countries/EastEur.txt" #Siberia
STE = "countries/EastEur.txt" #Steppes
CCD = "countries/EastEur.txt" #Centrocaspia
TAN = "countries/EastEur.txt" #Imperial Authority
MO2 = "countries/EastEur.txt" #Transbaikal
TRK = "countries/EastEur.txt" #General-Governorate of Turkestan
YDK = "countries/EastEur.txt" #Yudayakuo
MO4 = "countries/EastEur.txt" #Siberian People's Republic

### Mid East
ZAN = "countries/MidEast.txt" #Zanzibar
MAR = "countries/MidEast.txt" #Bosphorus Straits
KUR = "countries/MidEast.txt" #Kurdistan
AFG = "countries/MidEast.txt" #Afghanistan
IRQ = "countries/MidEast.txt" #Iraq
SAU = "countries/MidEast.txt" #Saudi Arabia
YEM = "countries/MidEast.txt" #Yemen
OMA = "countries/MidEast.txt" #Oman
PER = "countries/MidEast.txt" #Persia
LEB = "countries/MidEast.txt" #Lebanon
JOR = "countries/MidEast.txt" #Jordan
SYR = "countries/MidEast.txt" #Syria
EGY = "countries/MidEast.txt" #Eqypt
LBA = "countries/MidEast.txt" #Libya
PAL = "countries/MidEast.txt" #Palestine
PAK = "countries/MidEast.txt" #Pakistan
CEY = "countries/MidEast.txt" #Ceylon
TRA = "countries/MidEast.txt" #Travancore
MYS = "countries/MidEast.txt" #Mysore
ORS = "countries/MidEast.txt" #Order of the Star
HYD = "countries/MidEast.txt" #Hyderbad
RSR = "countries/MidEast.txt" #Rajasthan
ARY = "countries/MidEast.txt" #Aryanvata
PNJ = "countries/MidEast.txt" #Punjab
DIN = "countries/MidEast.txt" #Dinia
KSM = "countries/MidEast.txt" #Kashmir
IDR = "countries/MidEast.txt" #Indore
BIH = "countries/MidEast.txt" #Bihar
BNG = "countries/MidEast.txt" #Bangladesh
ASM = "countries/MidEast.txt" #Assam
ASY = "countries/MidEast.txt" #Assyria
MOR = "countries/MidEast.txt" #Morocco
SNP = "countries/MidEast.txt" #Syrian Social Nationalists

MAD = "countries/Commonw.txt" #Madras
UPI = "countries/Commonw.txt" #Churchlandia (United Provinces)

### Asian
BUR = "countries/Asian.txt" #Burma
SHA = "countries/Asian.txt" #Shandong/Zhili
BHU = "countries/Asian.txt" #Bhutan
CHI = "countries/Asian.txt" #China - unused
JAP = "countries/Asian.txt" #Japan
KOR = "countries/Asian.txt" #Korea
NEP = "countries/Asian.txt" #Nepal
SIA = "countries/Asian.txt" #Siam
SIK = "countries/Asian.txt" #Xinjiang
TIB = "countries/Asian.txt" #Tibet
YUN = "countries/Asian.txt" #Yunnan
MON = "countries/Asian.txt" #Anhui Clique
PHI = "countries/Asian.txt" #Philippines
MAN = "countries/Asian.txt" #Mantetsu/Fengtian
BYJ = "countries/Asian.txt" #Beiyang Government
MNG = "countries/Asian.txt" #Yellow Sands/Kaifeng
KMT = "countries/Asian.txt" #Kuomintang
DAI = "countries/Asian.txt" #Indochina
SMC = "countries/Asian.txt" #Saigon Clique
GXC = "countries/Asian.txt" #Guangxi
PRC = "countries/Asian.txt" #Commie China - usused
XSM = "countries/Asian.txt" #Ma Clique
VIN = "countries/Asian.txt" #Vietnam
CAM = "countries/Asian.txt" #Cambodia
MAL = "countries/Asian.txt" #Malaysia
LAO = "countries/Asian.txt" #Laos
ETS = "countries/Asian.txt" #Khotan Emirate
BKR = "countries/Asian.txt" #Buhkara
FJN = "countries/Asian.txt" #Fujian
GDP = "countries/Asian.txt" #Guangdong/Liangguang
SZC = "countries/Asian.txt" #Sichuan Clique
JGJ = "countries/Asian.txt" #Guominjun
XIA = "countries/Asian.txt" #Hunan Clique
JPR = "countries/Asian.txt" #Revolutionary Japan
TAI = "countries/Asian.txt" #Taiwan
KHW = "countries/Asian.txt" #Kwarazem
AQT = "countries/Asian.txt" #Kazakh Red Army
TUC = "countries/Asian.txt" #Turkestan-Caspian Union
TUK = "countries/Asian.txt" #Republic of Turkestan

### African
SOK = "countries/African.txt" #Sokoto
ETH = "countries/African.txt" #Ethiopia
ANG = "countries/African.txt" #Angola
LIB = "countries/African.txt" #Liberia
TUN = "countries/African.txt" #Tunisia
MZB = "countries/African.txt" #Mozambique
ZIM = "countries/African.txt" #Zimbabwe
COG = "countries/African.txt" #Congo
CFS = "countries/African.txt" #Congo Free State
MWA = "countries/African.txt" #Mwami Kingdom
KIV = "countries/African.txt" #Kivu
SAF = "countries/African.txt" #South Africa
TUA = "countries/African.txt" #Tuareg Free Territory
UPV = "countries/African.txt" #Upper Volta
MLI = "countries/African.txt" #Mali
GUN = "countries/African.txt" #Guinean Authority
KEN = "countries/African.txt" #Kenya
BOT = "countries/African.txt" #Botswana
MAG = "countries/African.txt" #Madagascar
SEN = "countries/African.txt" #Senegal
ALG = "countries/African.txt" #Algeria
YEP = "countries/African.txt" #Liberated Egypt
UGD = "countries/African.txt" #Uganda
SFC = "countries/African.txt" #Commie South Africa
BAC = "countries/African.txt" #Bantu Confederation
NGA = "countries/African.txt" #Nigeria
ET1 = "countries/African.txt"
ET2 = "countries/African.txt"
SML = "countries/African.txt" #Somali State
BET = "countries/African.txt" #Beta Israel

### South Am
ARG = "countries/SouthAm.txt" #Argentina
BOL = "countries/SouthAm.txt" #Bolivia
BRA = "countries/SouthAm.txt" #Brazil
URG = "countries/SouthAm.txt" #Uruguay
VEN = "countries/SouthAm.txt" #Venezuela
CHL = "countries/SouthAm.txt" #chile
COL = "countries/SouthAm.txt" #Colombia
COS = "countries/SouthAm.txt" #Costa Rica
ECU = "countries/SouthAm.txt" #Ecuador
ELS = "countries/SouthAm.txt" #El Salvador
MEX = "countries/SouthAm.txt" #Mexico
GUA = "countries/SouthAm.txt" #Guatemala
HON = "countries/SouthAm.txt" #Honduras
PAR = "countries/SouthAm.txt" #Paraguay
CUB = "countries/SouthAm.txt" #Cuba
DOM = "countries/SouthAm.txt" #Dominican Republic
HAI = "countries/SouthAm.txt" #Haiti
NIC = "countries/SouthAm.txt" #Nicaragua
PAN = "countries/SouthAm.txt" #Panama
PRU = "countries/SouthAm.txt" #Peru
NTB = "countries/SouthAm.txt" #Brazil but the northeast territory
BRR = "countries/SouthAm.txt" #Brazil but the reactionaries
CYN = "countries/SouthAm.txt" #Carribean
